######################################
#@ ==  !!!    =!!!    = ==!  !!!!!!!!#
#      =  ==  ==!===! = ==    !!!  !!#
#= !!  = !  !   !   ! = == ====!! ! !#
#==  =     =   !!!=            =!!  !#
# =  = === =  ==  = =  =  ! !! ==!!!!#
#        =    == !=   =!=      ===!!!#
#==  ==!    !          = ! == =====!!#
#        == ==== =  =      ==   =   !#
#== =! !     =   =!!===!!    !    =  #
#   =! ==!== = !!     =!! ! =  = === #
#!=     =    = = ===     == =!!=  =  #
#!= = =   =    =     = ! ==!=!!= === #
#!  = == ==  !!   !! =    =!==== === #
#!   !      =   == ! = ====!    ! =  #            
# ===! = ==!= =====  !     !=== ! = !#
# ===    ==     ==  =!= =  !!!!!=   !#
# !! !!!!   !! == ! = = =!!=   ===   #
# !!=  ========== =      !=!= =====  #
# =!   =!=!!==        = !! =        !#
# =!=  ========== =  ===!    ! = !! =#
# ===  !!        !        ==   =!==!=#
#    = !   ===  !=! !! = ==== =======#
#    = ==  =   !===!!! =      =======#
#!!!!!====    !=====!  =!==== =      #    
#!  !!     ! !=======! =      = === =#
#! ! !  ==  !=========!= ==== = === =#
#!!  !=  = !===========!         !! !#       
#!!!!!=  =!=============! ==!==  == ;#
######################################   