######################################
#       =   = =!!            !!      #
#     = = = = =!  =!!!!!!==! !!      #
#==== = = = = =   =    ====!   ====  #
#     =   =   =   =    =======   ==  #
#    ========== =====  ==    ==  ==  #    
# !===        =    ==  == !! ==  ==  #
# !===        =    ==!    !!      =  #
# ====  ====  ==== ==!!=  !!      =  #
# ====  =!!=  ====      ==  ===== =  #
# !===  =!!=      ====  ==  ===== =  #
# !===  ====      =    !==           #
#  ===     =====! ! !!====           #
#! ===     =!!!=! ! !!= ====  !!!  =!#
#  ======= = ! =! !  != ====  !!!  =!#                   
# !======= = ! =! ! !!= ====  !!!  = #
#          = ! =!@!; != ====   !!!  =#
#      !!!!=   =!!!!!!=   ==  !!!  = #
# !=========   ======== = ==  !!!  = #
#  =                    =          = #
#! =      ==========!!!!====       = #
#  =  =====        !      !!  ====== #
# !=  =====        !=======!  =      # 
# !=  =      ====  !!     !!  = !=!= # 
#  =  =      =!!=  !! !!!     = !=!= #          
#  =  =  =====!!=         ===== ==== # 
#  ====  ==     ===========        = #
#                           ==== ! = #             
#                                !   #
######################################        