######################################
#       =   = =!!            !!      #
#     = = = = =!  =!!!!!!==! !!      #
#==== = = = = =   =    ====!   ====  #
#     =   =   =   =    =======   ==  #
#    ========== =====  ==    ==  ==  #    
# !===        =    ==  == !! ==  ==  #
# !===        =    ==!    !!      =  #
# ====  ====  ==== ==!!=  !!      =  #
# ====  =!!=  ====      ==  ===== =  #
# !===  =!!=      ====  ==  ===== =  #
# !===  ====      =    !==           #
#  ===     =====! ! !!====           #
#! ===     =!!!=! ! !!= ====  !!!  =!#
#  ======= = ! =! !  != ====  !!!  =!#                   
# !======= = ! =! ! !!= ====  !!!  = #
#          = ! =!@!; != ====  !!!  = #
#      !!!!=   =!!!!!!=   ==  !!!  = #
# !=========   ======== = ==  !!!  = #
#  =                    =          = #
#! =      ==========!!!!====       = #
#  =  =====        !      !!  ====== #
# !=  =====        !=======!  =      # 
# !=  =      ====  !!     !!  = !=!= # 
#  =  =      =!!=  !! !!!    == !=!= #          
#  =  =  =====!!=         ====  ==== # 
#  ====  ==     ===========    =   = #
#  !!   !!                  ==== ! = #             
#!    !    !!!!!!                !   #
######################################        