######################################
#                 =              =   #
#@             .!!!  !!!!!!!!!!  =.=.#
#======.!=      !    ==========..!.=.# 
#!!!!!=..=..====!    ==========..!.=.#
#!!!!!=!.=..=      ============..!.=.#     
#======..=..=      ============..!.=.#                
#       !=..=..====              !.=.#  
#   !! !!=..=..====              !.=.# 
#..=======..=    ==..========!!!!!.=.#         
#..=        =    ==..=             =.#
#!.=        ===..==..=      ========.#  
#!.============..==..=  =====        #     
#..==            ==..=  !!!!!..!!!!!!#                                             
#..==            ==..=  =====..======#     
#..==..============..=               #       
#..==..=!!      ===..=               # 
#..==..=!!      =   !=      =..====..#
#..==..=======..=..!!=.!!!!.=..=  =..#     
#..==        =..=..===      =..=  =..#
#.!==        =..=..==========..====!.#  
#.!========..=..=..==          == !!.#  
#..========..=..=..==          ==    # 
#            =..=..!!..==========..!!#           
#            =..=..!!..=!!!!!!!!=..!!#    
#==..=========..=      =!      !=!.!!#     
#==..=========..=!!!!!!=!      !=!.!!#             
#==             ========!..!!..     ;#  
#==             ========!..!!..     ;#            
######################################