##########
#,,.!..,,#
#,,....,,#
#,,####,,;
#@,####,,;
#,,#######
#,,###...#
#,,..#...#
#,,..#...#
##########